AD_Alt	tum-vad-col
AD_Ref	tum-rad-col
Depth	tum-depth-col
i_n_alt_count	nrm-vad-col
i_n_ref_count	nrm-rad-col
i_t_alt_count	tum-vad-col
i_t_ref_count	tum-rad-col
n_alt_count	nrm-vad-col
n_alt Count	nrm-vad-col
n_depth	nrm-depth-col
Norm_AD_Alt	nrm-vad-col
Norm_AD_Ref	nrm-rad-col
normal_depth	nrm-depth-col
Normal_ReadCount_Alt	nrm-vad-col
Normal_ReadCount_Ref	nrm-rad-col
Normal_ReadCount_Total	nrm-depth-col
NormalRefCount_VS	nrm-rad-col
normal_ref_reads	nrm-rad-col
NormalRefReads_WU	nrm-rad-col
NormalTotalCount_VS	nrm-depth-col
NormalVarCount_VS	nrm-vad-col
normal_var_reads	nrm-vad-col
NormalVarReads_WU	nrm-vad-col
n_readcount	nrm-depth-col
n_ref_count	nrm-rad-col
n_ref_count	nrm-rad-col
n_ref Count	nrm-rad-col
nrm_reads	nrm-depth-col
NTotCov	nrm-depth-col
NUM_OF_ALT_READS	tum-vad-col
NUM_OF_REF_READS	tum-rad-col
n_var_count	nrm-vad-col
NVarCov	nrm-vad-col
rna_depth	tum-depth-col
samplecov	tum-depth-col
t_alt_count	tum-vad-col
t_alt Count	tum-vad-col
Tcov	tum-depth-col
t_depth	tum-depth-col
t_readcount	tum-depth-col
t_ref_count	tum-rad-col
t_ref Count	tum-rad-col
Trna_ref	tum-rad-col
Trna_tot	tum-depth-col
Trna_var	tum-vad-col
T_TotalDepth	tum-depth-col
TTotCov	tum-depth-col
tumor_depth	tum-depth-col
Tumor_ReadCount_Alt	tum-vad-col
Tumor_ReadCount_Ref	tum-rad-col
Tumor_ReadCount_Total	tum-depth-col
TumorRefCount_VS	tum-rad-col
tumor_ref_reads	tum-rad-col
TumorRefReads_WU	tum-rad-col
tumors_var_reads	tum-vad-col
TumorTotalCount_VS	tum-depth-col
TumorVarCount_VS	tum-vad-col
tum_reads	tum-depth-col
t_var_count	tum-vad-col
TVarCov	tum-vad-col
